1111111111111111111111111111111111
1E100000C00000000000000000000100C1
1010010100100000101001000000010101
1010010010101010001001000000010111
100PCCCC00000000000000000000000001
1111111111111111111111111111111111
